11111111111111111111111111111111111
100000000000000000000000C0000000001
10000000000000000000000000000000001
10000000000000000000000000000000001
10000000000000000000000000010000001
10000000000000000000000000000000001
10000000000000000000000000100000001
10000000000000000000000000000000001
100000000C0000000000000000000000001
10000000000000000000000000000000001
10000000000000000000000000000000001
10000000000P00000000000000000000001
10000000000000000000000000000000001
10000000000000000000000000000000001
10000000000000000000000000000000001
10000000C00000000000000000000000001
100000000000000000000000000000C0001
10000000000000000000000000000000001
10000100000000000000000000000000001
1000000000000000000000000000C000001
100000000000000000E1000000000000001
10000000000000000000000000000000001
10000000000000000000000000000000001
10000000000000000000000000000000001
10000000000000000000000000000000001
1000000000000000000000000000000C001
10000000000000000000C00000000000001
10000000000000000000000000000000001
10000000000000000000000000000000001
100000C0000000000000000000000000001
10000000000000000000000000000000001
10001000000000000000000000000000001
1000C000000000000000000000000000001
1000000000C000000000000000000000001
11111111111111111111111111111111111